[B][B][B][B][B][B][B]
[B][0][0][0][$][$][B]
[B][0][S][0][0][$][B]
[B][0][0][0][0][$][B]
[B][0][0][0][0][$][B]
[B][0][0][0][0][E][B]
[B][B][B][B][B][B][B]