[B][B][B][B][B][B][B][B][B][B][B][B]
[B][S][$][$][0][0][0][$][0][0][0][B]
[B][0][0][0][0][0][B][$][$][$][0][B]
[B][0][0][0][0][0][B][0][0][$][$][B]
[B][0][0][0][0][0][B][B][B][B][$][B]
[B][0][0][0][0][0][0][0][0][B][$][B]
[B][B][B][B][B][B][$][B][B][B][$][B]
[B][E][$][$][$][$][$][$][$][$][$][B]
[B][B][B][B][B][B][B][B][B][B][B][B]