[B][B][B][B][B][B][B]
[B][0][0][0][0][0][B]
[B][0][S][E][0][0][B]
[B][0][0][0][0][0][B]
[B][0][0][0][0][0][B]
[B][0][0][0][0][0][B]
[B][B][B][B][B][B][B]