[B][B][B][B][B][B][B][B][B][B][B][B]
[B][S][$][$][0][0][0][$][0][0][0][B]
[B][0][0][0][0][0][B][$][$][$][0][B]
[B][0][0][0][0][0][B][P2][0][$][$][B]
[B][0][0][0][0][0][B][B][B][B][$][B]
[B][0][0][0][0][0][0][0][0][B][$][B]
[B][B][B][B][B][B][$][B][B][B][H2][B]
[B][E][H1][H1][H1][$][$][$][H2][$][P1][B]
[B][B][B][B][B][B][B][B][B][B][B][B]