[B][B][B][B][B][B][B][B][B][B][B][B][B][B]
[B][0][0][0][0][0][0][0][0][0][0][0][0][B]
[B][0][S][0][0][K1][0][0][0][0][0][0][0][B]
[B][0][0][0][0][0][0][0][0][0][0][0][0][B]
[B][B][D1][B][0][0][0][0][0][0][0][0][0][B]
[B][E][0][B][0][0][0][0][0][0][0][0][0][B]
[B][B][B][B][0][0][0][0][0][0][0][0][0][B]
[B][0][0][0][0][0][0][0][0][0][0][0][0][B]
[B][0][0][0][0][0][0][0][0][0][0][0][0][B]
[B][0][0][0][0][0][0][0][0][0][0][0][0][B]
[B][0][0][0][0][0][0][0][0][0][0][0][0][B]
[B][B][B][B][B][B][B][B][B][B][B][B][B][B]